3

40 30 2
OOOOOOOOOOOOOOOOOOOOOOOOOOOOOOOOOOOOOOOO
O     c   b                            O
OO   OOOOOOOOOOOOO  OOOOOOOOOOOOOOOOOOOO
O     d          O                 r   O
O    a           O   P r           OO  O
OOOOOOOOOOOOOO  OOO  OOOOOOOO  OOOOO   O
O  d            dO    b a         r    O
O            P   O                 b   O
OOOOOOOOOO  OOOOOO   OOOOOOOOO  OOOOOOOO
O     c        O     O             e   O
Ob O  OOOOOOOO O     O e             c O
O  O           O     O          e      O
OOOO  f    L   OO   OOO  OOOOOOOOOOOOOOO
O                                      O
OOOOOOOOOOOOOOOOOOOOOOOOOOOOOO     OOOOO
O   z f                         z      O
O                  z                   O
OOOOOOOOOOOOOOOOOOOOOOOOOO  OOOOOOOOOOOO
O                                      O
O     f                           g    O
O                                      O
OOO  OOOOOOOOOOOOOOOOOOOOO  OOOOOOOOOOOO
O                                      O
O     g           a                    O
OOOOOOOOOOO  OOOOOOOOOOOOOOOOOOO   OO  O
O                                 g    O
O                                      O
O  OOOOOOOOOOOOOOOOOOOOOOOOOOOOOOOOOOOOO
O                  b                   O
OOOOOOOOOOOOOOOOOOOOOOOOOOOOOOOOOOOOOOOO
39 7  38  7  1  0
39 25 38 25  1  1


40 30 3
OOOOOOOOOOOOOOOOOOOOOOOOOOOOOOOOOOOOOOOO
O                                      O
O                                      O
O                                      O
O                                 g    O
O                                      O
O                                      O
O                                      O
O                                      O
O                                      O
O                                      O
O              OOOOOOOOO               O
O             aO a                     O
O           OOOOOOOOO OOOOOOOOOOOOOOO OO
O           O     O                    O
O           O    aO                    O
O                 Oa              g    O
O           O     O                    O
O                 O                    O
O                 O                    O
O                 O                    O
O                 O                    O
O                 O                    O
O                 O                    O
O                 O                    O
O                 O                    O
O                 O                    O
O                 O                    O
O                 O                    O
OOOOOOOOOOOOOOOOOOOOOOOOOOOOOOOOOOOOOOOO
30 29 30 28 0 0
15 29 15 28 0 1
39 10 38  9 2 0


40 30 1
OOOOOOOOOOOOOOOOOOOOOOOOOOOOOOOOOOOOOOOO
O                                      O
O                                  OL  O
O                                  O  LO
O                                  OL  O
O                                 gO  LO
O                                  OL  O
O                                  O  LO
O                               OOOOL  O
O                               O  L   O
O             OOOOOOOOOO        O      O
O            OO        OOOOOOOOOO    OOO
O            O            P         S OO
O            O                        OO
O            OO        OOOOOOOOOO    OOO
O             O       LO        O      O
O                         P     O  L   O
O                               OOOOL  O
O                 O               gO  LO
O                 O                OL  O
O                 O                O  LO
O                 O                OL  O
O                 O                O  LO
O                 O                OL  O
O                 O                    O
O                 O                    O
O                 O                    O
O                 O                    O
O                 O                    O
OOOOOOOOOOOOOOOOOOOOOOOOOOOOOOOOOOOOOOOO
5  0  5  1 1 2
