2

40 30 2
OOOOOOOOOOOOOOOOOOOOOOOOOOOOOOOOOOOOOOOO
O                                      O
O                                      O
O                O                     O
O                O   P             OOOOO
O                O             P       O
O                O                     O
O                O  P                  O
O            P   O           L         O
O              OOO                     O
O              O                       O
O  O OOOOOOOOO O                       O
O  O           O                       O
OOOO           OO   OOOOOOOOOOOOOOOOOOOO
O                                      O
O                                      O
O                                      O
O                                      O
O                                      O
O                                      O
O                                      O
O                                      O
O                                      O
O                                      O
O                                      O
O                                      O
O                                      O
O                                      O
O                                      O
OOOOOOOOOOOOOOOOOOOOOOOOOOOOOOOOOOOOOOOO
39 7  38  7  1  0
39 25 38 25  1  1


40 30 2
OOOOOOOOOOOOOOOOOOOOOOOOOOOOOOOOOOOOOOOO
O                                      O
O                                      O
O                                      O
O                                      O
O                                      O
O                                      O
O                                      O
O                                      O
O                                      O
O                                      O
O              OOOOOOOOO               O
O              O                       O
O           OOOOOOOOOOOOOOOOOOOOOOOOOOOO
O           O     O                    O
O           O     O                    O
O                 O                    O
O           O     O                    O
O                 O                    O
O                 O                    O
O                 O                    O
O                 O                    O
O                 O                    O
O                 O                    O
O                 O                    O
O                 O                    O
O                 O                    O
O                 O                    O
O                 O                    O
OOOOOOOOOOOOOOOOOOOOOOOOOOOOOOOOOOOOOOOO
30 29 30 28 0 0
15 29 15 28 0 1
