2

40 30 2
OOOOOOOOOOOOOOOOOOOOOOOOOOOOOOOOOOOOOOOO
O     c   b                            O
OO   OOOOOOOOOOOOO  OOOOOOOOOOOOOOOOOOOO
O     d          O           L     r   O
O    a           O   P r           OO  O
OOOOOOOOOOOOOO  OOO  OOOOOOOO  OOOOO   O
O  d            dO    b a         r    O
O            P   O                 b   O
OOOOOOOOOO  OOOOOO   OOOOOOOOO  OOOOOOOO
O     c        O     O     L       e   O
Ob O  OOOOOOOO O     O e             c O
O  O           O     O          e      O
OOOO  f    L   OO   OOO  OOOOOOOOOOOOOOO
O                 L                    O
OOOOOOOOOOOOOOOOOOOOOOOOOOOOOO     OOOOO
O   z f                         z      O
O                  z                   O
OOOOOOOOOOOOOOOOOOOOOOOOOO  OOOOOOOOOOOO
O                                      O
O     f                           g    O
O                                      O
OOO  OOOOOOOOOOOOOOOOOOOOO  OOOOOOOOOOOO
O                                      O
O     g           a                    O
OOOOOOOOOOO  OOOOOOOOOOOOOOOOOOO   OO  O
O                                 g    O
O                                      O
O  OOOOOOOOOOOOOOOOOOOOOOOOOOOOOOOOOOOOO
O                  b                   O
OOOOOOOOOOOOOOOOOOOOOOOOOOOOOOOOOOOOOOOO
39 7  38  7  1  0
39 25 38 25  1  1


40 30 2
OOOOOOOOOOOOOOOOOOOOOOOOOOOOOOOOOOOOOOOO
O                                      O
O                                      O
O                                      O
O                                 g    O
O                                      O
O                                      O
O                                      O
O                                      O
O                                      O
O                                      O
O              OOOOOOOOO               O
O             aO a                     O
O           OOOOOOOOO OOOOOOOOOOOOOOO OO
O           O     O                    O
O           O    aO                    O
O                 Oa              g    O
O           O     O                    O
O                 O                    O
O                 O                    O
O                 O                    O
O                 O                    O
O                 O                    O
O                 O                    O
O                 O                    O
O                 O              S     O
O                 O                    O
O                 O                    O
O                 O                    O
OOOOOOOOOOOOOOOOOOOOOOOOOOOOOOOOOOOOOOOO
30 29 30 28 0 0
15 29 15 28 0 1
